00000000000000000000
00000000000000000000
00000000000000000000
00000000001111100000
00000000001222100000
00000000011223111000
00000000111322221000
00111111123223221110
00144221121112122210
00144252222223223210
00144221211112111110
00111111222222210000
00000001111111100000
00000000000000000000
00000000000000000000
00000000000000000000
00000000000000000000
00000000000000000000
00000000000000000000
00000000000000000000