00000000000000000000
00000000000000000000
00000000000000000000
00000000111111100000
00000001122125100000
00000001222122100000
00000001323232100000
00000001221122100000
00000111231222100000
00000122232221100000
00000144444221000000
00000111111111000000
00000000000000000000
00000000000000000000
00000000000000000000
00000000000000000000
00000000000000000000
00000000000000000000
00000000000000000000
00000000000000000000