00000000000000000000
00000000000000000000
00000000000000000000
00000000000000000000
00000000000000000000
00000000000000000000
00000000000000000000
00001111001111000000
00011221001222100000
00012321111322100000
00012234444232100000
00012222112522100000
00001222222221000000
00000122112210000000
00000012222100000000
00000001221000000000
00000000110000000000
00000000000000000000
00000000000000000000
00000000000000000000