00000000000000000000
00000000000000000000
00000000000000000000
01111111111111111110
01222222222222222210
01229999222999922210
01229222222222923210
01229999222999922210
01222229222922223210
01229999222999922210
01222222222222222210
01222224222422322210
01222422424224223210
01232422252224223210
01232242222242222210
01232224222422233210
01232222424223332210
01222322242222222210
01111111111111111110
00000000000000000000