00000000000000000000
00000000000000000000
00000000000000000000
00000000000000000000
00000000000000000000
00000001111111000000
00000001254441000000
00000001222111100000
00000011132222100000
00000012221312100000
00000012321222100000
00000012221111100000
00000011111100000000
00000000000000000000
00000000000000000000
00000000000000000000
00000000000000000000
00000000000000000000
00000000000000000000
00000000000000000000