00000000000000000000
00000000000000000000
00000000000000000000
00000000000000000000
00000111111000000000
00000152221100000000
00111123224110000000
00122232324410000000
00112323224410000000
00012221111110000000
00001111000000000000
00000000000000000000
00000000000000000000
00000000000000000000
00000000000000000000
00000000000000000000
00000000000000000000
00000000000000000000
00000000000000000000
00000000000000000000